T------------------7
|                |k|
|  T---   --     --|
|  |               |
|  |               |
|  |  T---         |
|  |  |            |
|  L--J            |
|          ------  |
|  ---             |
|                  |  
|          ------  |
|                  |
|       --         |
L------------------J