T------------------7
|            k     |
|  T---   --   --  |
|  |  k            |
|k |      k     k  |
|  |  T---   k     |
|  | k|         k  |
|  L--J  k         |
| k        ------  |
|  ---           k |
|        k    k    |  
|   k      ------  |
|        k      k  |
|   k   --    k    |
L------------------J
