T------------------7
|            k     |
|  T---   --   --  |
|  |               |
|  |               |
|  |  T---   k     |
|  |  |            |
|  L--J            |
| k        ------  |
|  ---           k |
|        k         |  
|          ------  |
|                  |
|       --         |
L------------------J