T------------------7
|                  |
|  T--- k --   --  |
|  |               |
|k |       k       |
|  |  T--     k    |
|  |  |            |
|  L--J   k      k |
| k         ---    |
|  ---  k          |
|                  |  
| k        ------  |
|      k           |
|       --         |
L------------------J